1:2	24:1	24:1	1:2	1:2	1:2	1:2	1:2	1:2	1:2	1:2	1:2	1:2	1:2	24:1	24:1	1:2	1:2	1:2	1:2
1:2	24:1	24:1	24:1	1:2	1:2	1:2	1:2	1:2	1:2	1:2	1:2	1:2	1:2	24:1	24:1	24:1	24:1	1:2	24:1
1:2	24:1	24:1	24:1	24:1	1:2	1:2	1:2	24:1	24:1	1:2	1:2	1:2	24:1	24:1	24:1	24:1	24:1	24:1	24:1
1:2	1:2	24:1	24:1	24:1	1:2	1:2	24:1	24:1	24:1	24:1	1:2	24:1	24:1	24:1	24:1	24:1	24:1	24:1	24:1
1:2	1:2	24:1	24:1	24:1	1:2	24:1	24:1	24:1	24:1	24:1	24:1	24:1	24:1	24:1	24:1	24:1	24:1	24:1	24:1
1:2	1:2	24:1	24:1	24:1	24:1	24:1	24:1	24:1	24:1	24:1	24:1	24:1	24:1	24:1	24:1	24:1	24:1	24:1	24:1
1:2	1:2	1:2	24:1	24:1	24:1	24:1	24:1	24:1	24:1	24:1	24:1	24:1	24:1	24:1	24:1	24:1	24:1	1:2	1:2
1:2	1:2	1:2	24:1	24:1	24:1	24:1	24:1	24:1	24:1	24:1	24:1	24:1	24:1	24:1	24:1	1:2	1:2	24:1	24:1
1:2	1:2	1:2	24:1	24:1	24:1	24:1	24:1	24:1	24:1	24:1	24:1	1:2	1:2	1:2	1:2	24:1	24:1	24:1	24:1
1:2	1:2	1:2	1:2	24:1	24:1	24:1	24:1	1:2	1:2	1:2	1:2	24:1	24:1	24:1	24:1	24:1	24:1	24:1	24:1
