10:1	10:1	10:1	10:1	10:1	10:1	10:1	10:1	10:1	10:1	10:1	10:1	10:1	10:1	10:1	10:1	10:1	10:1	10:1	10:1	10:1	10:1	10:1	10:1	10:1	10:1	10:1	10:1	10:1	10:1	10:1	10:1	10:1	10:1	10:1	10:1	10:1	10:1	10:1	10:1
10:1	10:1	10:1	10:1	10:1	10:1	10:1	10:1	10:1	10:1	10:1	10:1	10:1	10:1	10:1	10:1	10:1	10:1	10:1	10:1	10:1	10:1	10:1	10:1	10:1	10:1	10:1	10:1	10:1	10:1	10:1	10:1	10:1	10:1	10:1	10:1	10:1	10:1	10:1	10:1
10:1	10:1	10:1	10:1	10:1	10:1	10:1	10:1	10:1	10:1	10:1	10:1	10:1	10:1	10:1	10:1	10:1	10:1	10:1	10:1	10:1	10:1	10:1	10:1	10:1	10:1	10:1	10:1	10:1	10:1	10:1	10:1	10:1	10:1	10:1	10:1	10:1	10:1	10:1	10:1
10:1	10:1	10:1	10:1	10:1	10:1	10:1	10:1	10:1	10:1	10:1	10:1	10:1	10:1	10:1	10:1	10:1	10:1	10:1	10:1	10:1	10:1	10:1	10:1	10:1	10:1	10:1	10:1	10:1	10:1	10:1	10:1	10:1	10:1	10:1	10:1	10:1	10:1	10:1	10:1
10:1	10:1	10:1	10:1	10:1	10:1	10:1	10:1	10:1	10:1	10:1	10:1	10:1	10:1	10:1	10:1	10:1	10:1	10:1	10:1	10:1	10:1	10:1	10:1	10:1	10:1	10:1	10:1	10:1	10:1	10:1	10:1	10:1	10:1	10:1	10:1	10:1	10:1	10:1	10:1
10:1	10:1	10:1	10:1	10:1	10:1	10:1	10:1	10:1	10:1	10:1	10:1	10:1	10:1	10:1	10:1	10:1	10:1	10:1	10:1	10:1	10:1	10:1	10:1	10:1	10:1	10:1	10:1	10:1	10:1	10:1	10:1	10:1	10:1	10:1	10:1	10:1	10:1	10:1	10:1
10:1	10:1	10:1	10:1	10:1	10:1	10:1	10:1	10:1	10:1	10:1	10:1	10:1	10:1	10:1	10:1	10:1	10:1	10:1	10:1	10:1	10:1	10:1	10:1	10:1	10:1	10:1	10:1	10:1	10:1	10:1	10:1	10:1	10:1	10:1	10:1	10:1	10:1	10:1	10:1
10:1	10:1	10:1	10:1	10:1	10:1	10:1	10:1	10:1	10:1	10:1	10:1	10:1	10:1	10:1	10:1	10:1	10:1	10:1	10:1	10:1	10:1	10:1	10:1	10:1	10:1	10:1	10:1	10:1	10:1	10:1	10:1	10:1	10:1	10:1	10:1	10:1	10:1	10:1	10:1
10:1	10:1	10:1	10:1	10:1	10:1	10:1	10:1	10:1	10:1	10:1	10:1	10:1	10:1	10:1	10:1	10:1	10:1	10:1	10:1	10:1	10:1	10:1	10:1	10:1	10:1	10:1	10:1	10:1	10:1	10:1	10:1	10:1	10:1	10:1	10:1	10:1	10:1	10:1	10:1
10:1	10:1	10:1	10:1	10:1	10:1	10:1	10:1	10:1	10:1	10:1	10:1	10:1	10:1	10:1	10:1	10:1	10:1	10:1	10:1	10:1	10:1	10:1	10:1	10:1	10:1	10:1	10:1	10:1	10:1	10:1	10:1	10:1	10:1	10:1	10:1	10:1	10:1	10:1	10:1
10:1	10:1	10:1	10:1	10:1	10:1	10:1	10:1	10:1	10:1	10:1	10:1	10:1	10:1	10:1	10:1	10:1	10:1	10:1	10:1	10:1	10:1	10:1	10:1	10:1	10:1	10:1	10:1	10:1	10:1	10:1	10:1	10:1	10:1	10:1	0:1	0:1	10:1	10:1	10:1
10:1	10:1	10:1	10:1	10:1	10:1	10:1	10:1	10:1	10:1	10:1	10:1	10:1	10:1	10:1	10:1	10:1	10:1	10:1	10:1	10:1	10:1	10:1	10:1	10:1	10:1	10:1	10:1	10:1	10:1	10:1	10:1	10:1	10:1	0:1	4:2	4:2	0:1	10:1	10:1
10:1	10:1	10:1	10:1	10:1	10:1	10:1	10:1	10:1	10:1	10:1	10:1	10:1	10:1	10:1	10:1	10:1	10:1	10:3	10:1	10:1	10:1	10:1	10:1	10:1	10:1	10:1	10:1	10:1	10:1	10:1	10:1	10:1	0:1	4:2	5:2	5:2	4:2	10:1	10:1
10:1	10:1	10:1	10:1	10:1	10:1	10:1	10:1	10:1	10:1	10:1	10:1	10:1	10:1	10:1	10:1	10:1	0:1	0:1	0:1	0:1	0:1	10:1	10:1	10:1	10:1	10:1	10:1	10:1	10:1	10:3	10:1	0:1	4:2	5:2	6:2	6:2	5:2	0:1	10:1
10:1	10:1	10:1	10:1	10:1	10:1	10:1	10:1	10:1	10:1	10:1	10:1	10:1	10:1	10:1	10:1	0:1	4:2	4:2	4:2	4:2	4:2	0:1	10:1	10:1	10:1	10:1	10:1	0:1	0:1	0:1	0:1	4:2	5:2	6:2	6:2	6:2	6:2	4:2	10:1
10:1	10:1	10:1	10:1	10:1	0:1	0:1	10:1	10:1	10:1	10:1	10:1	10:1	10:1	10:1	0:1	4:2	5:2	5:2	5:2	5:2	5:2	4:2	10:1	10:1	10:1	10:1	0:1	4:2	4:2	4:2	4:2	5:2	6:2	6:2	6:2	6:2	6:2	5:2	0:1
10:1	10:1	10:1	0:1	0:1	4:2	4:2	0:1	0:1	10:1	10:1	10:1	10:1	10:1	0:1	4:2	5:2	6:2	6:2	6:2	6:2	6:2	5:2	10:1	10:1	10:1	0:1	4:2	5:2	5:2	5:2	5:2	6:2	6:2	6:2	6:2	6:2	6:2	6:2	4:2
0:1	0:1	0:1	4:2	4:2	5:2	5:2	4:2	4:2	10:1	10:1	10:1	10:1	10:1	4:2	5:2	6:2	6:2	6:2	6:2	6:2	6:2	6:2	0:1	0:1	0:1	4:2	5:2	6:2	6:2	6:2	6:2	6:2	6:2	6:2	6:2	6:2	6:2	6:2	5:2
4:2	4:2	4:2	5:2	5:2	6:2	6:2	5:2	5:2	10:1	10:1	10:1	10:1	10:1	5:2	6:2	6:2	6:2	6:2	6:2	6:2	6:2	6:2	4:2	4:2	4:2	5:2	6:2	6:2	6:2	6:2	6:2	6:2	6:2	6:2	6:2	6:2	6:2	6:2	6:2
5:2	5:2	5:2	6:2	6:2	6:2	6:2	6:2	6:2	10:1	10:1	10:1	10:1	10:1	6:2	6:2	6:2	6:2	6:2	6:2	6:2	6:2	6:2	5:2	5:2	5:2	6:2	6:2	6:2	6:2	6:2	6:2	6:2	6:2	6:2	6:2	6:2	6:2	6:2	6:2
